##########
#       G#
#   ###  #
#   # #  #
#   ###  #
#  P     #
##########