################
#  # G         #
#  #           #
#          #####
#  P           #
#  #####       #
#  #           #
#  #       #####
#  #           #
################