########
# P # G#
#   #  #
#      #
#   #  #
#   #  #
########