##########
# P #    #
#   #    #
#        #
#   ###  #
#   # G  #
##########