################
#  # G         #
#  #           #
#          #####
#              #
#  #####       #
#  #           #
#  #       #####
#  #  P        #
################