#####
#   #
# # #
# # #
#G#P#
#####