##########
# P #   #
#   #    #
#        #
#   ###  #
#   # G  #
##########